NO si_fi.xpm
SO si_fi.xpm
WE wall.xpm
EA wall.xpm



F   164, 169, 2
C 153 ,   204, 255




111111111111111111111
100000000000010000001
100000000000010000001
101110000000010000001
100000000000010000001
100000000000000000001
100000000000000000001
1000000000000E0000001
100000000000000000001
100000000000000000001
111111100000000000001
100000000000000000001
111111111111111111111


