EA 1.xpm
NO 2.xpm   
WE 3.xpm
SO 4.xpm



F   164, 169, 2
C 153 ,   204, 255




111111111111111111111
101000001000000000001
101010101011111110001
100010100010000010001
111110101111101011101
100000101000101000001
101111101011101111111
101110101110101110111
101000100000100010101
111011000001111010101
100110000000000010001
100000111011111111101
1N0100001000000000001
111111111111111111111
    



