EA 1.xpm
NO 2.xpm   
WE 3.xpm
SO 4.xpm



F   164, 169, 2
C 153 ,   204, 255




111111111111111111111
100000000000010000001
100000000000010000001
101110000000010000001
100000000000010000001
100000000000000000001
1000000000N0000000001
100000000000000000001
100000000000000000001
100000000000000000001
111111100000000000001
100000000000000000001
111111111111111111111


